11111111111111111111111
12222222222222222222221
12222221111111112222221
11112222222222222221111
12222221111111112222221
12222222222222222222221
12222222111011122222221
11111212100400121211111
00001212100400121210000
00001212100400121210000
00001212100400121210000
11111212111111121211111
12222222222322222222221
12222222222222222222221
12222221111111112222221
11112222222522222221111
12222221111111112222221
12222222222222222222221
12222222222222222222221
11111111111111111111111