11111111111111111111111
12212222222222222221221
12252211112521111225221
11112212222222221221111
12222112211111221122221
12122212222222221222121
12522222111011122222521
11111222100400122211111
00001222100400122210000
00001222100400122210000
00001222100400122210000
11111222111111122211111
12222222222322222222221
12221221222222212221221
12222211221112211222221
11112522211111222521111
12222222222222222222221
12221111222122211112221
12222222221112222222221
11111111111111111111111