11111111111111111111111
10010000000000000001001
10000011110001111000001
11110010000000001001111
10000110011111001100001
10100010000000001000101
10000000111011100000001
11111000100400100011111
00001000100400100010000
00001000100400100010000
00001000100400100010000
11111000111111100011111
10000000000320000000001
10001001000000010001001
10000011001110011000001
11110000011111000001111
10000000000500000000001
10001111000100011110001
10000000001110000000001
11111111111111111111111